1,1,1,1,1,1,1,1,1,1,1,1,1,1,1,1,1,1,1,1,1,1,1,1,1,1,1,1,1,1,1,1,1,1,1,1,1,1,1,1,1
1,0,0,0,0,0,2,5,0,0,0,0,0,0,0,0,2,0,0,0,0,0,0,0,0,0,0,0,8,3,6,0,0,0,7,0,0,0,0,5,1
1,0,0,0,0,6,2,0,7,0,2,3,0,0,2,0,3,0,7,0,2,3,1,1,0,0,0,2,0,2,2,2,0,0,0,0,0,3,0,0,1
1,0,0,1,1,3,3,0,0,0,0,2,0,0,2,0,0,0,0,0,0,0,5,1,0,0,0,1,0,0,0,0,0,3,3,0,0,2,0,3,1
1,3,0,0,0,0,0,0,0,0,0,2,0,0,0,0,0,1,0,0,0,0,0,3,0,0,3,3,0,0,0,0,0,0,0,0,0,1,0,8,1
1,0,0,0,0,0,0,8,2,0,0,0,0,0,0,6,0,1,0,0,3,0,0,0,0,0,0,0,0,0,5,2,0,3,2,2,0,1,0,0,1
1,0,0,2,0,0,0,3,2,0,0,0,1,3,2,2,0,3,0,0,3,8,0,0,0,3,0,7,0,2,1,1,6,0,0,0,0,0,7,0,1
1,0,0,2,0,7,0,0,0,0,0,0,1,0,0,0,0,3,0,0,3,2,2,0,0,0,0,0,0,0,0,0,0,0,0,0,2,0,0,0,1
1,0,0,3,0,0,0,0,1,0,0,0,0,0,2,0,0,2,0,0,0,5,1,0,0,2,3,3,0,0,0,8,3,0,0,0,2,2,3,0,1
1,5,0,0,0,0,0,0,1,0,2,2,0,0,2,0,0,2,0,0,0,0,1,0,0,0,0,0,0,2,3,1,1,0,0,0,0,5,2,0,1
1,2,0,0,0,2,0,0,3,0,0,0,0,0,1,5,0,0,0,4,0,0,0,0,0,0,0,0,0,2,0,0,0,0,1,0,0,0,2,0,1
1,0,0,0,5,1,0,0,0,0,0,0,2,0,1,1,0,0,0,0,0,0,0,0,0,2,2,2,0,0,0,0,2,1,1,0,0,0,0,0,1
1,0,3,2,1,1,0,0,6,0,0,2,3,0,0,0,8,0,0,0,0,1,6,0,0,0,5,3,0,0,2,0,0,0,0,0,2,0,2,3,1
1,0,8,0,0,0,0,0,0,0,0,0,0,0,0,2,3,2,0,0,1,1,3,0,0,0,0,0,0,0,1,0,0,0,0,0,2,0,6,3,1
1,0,2,0,0,0,0,0,1,3,0,0,0,0,0,0,0,0,0,0,3,5,0,0,0,0,0,0,0,6,1,5,0,2,7,0,3,0,0,0,1
1,0,3,0,0,0,7,0,2,3,0,0,0,2,0,2,0,7,0,0,3,0,0,3,3,0,0,2,1,1,1,1,3,2,0,0,3,1,1,0,1
1,0,2,5,0,0,0,0,3,0,0,7,0,0,0,2,0,0,0,0,2,0,0,0,0,0,0,2,0,0,0,0,0,0,0,0,0,0,0,0,1
1,0,2,2,1,1,0,0,0,0,0,0,0,0,0,3,0,8,2,0,0,0,0,0,0,0,0,0,0,0,3,2,0,0,2,0,0,0,0,0,1
1,0,0,0,6,1,0,0,0,0,1,1,1,2,0,0,0,2,3,0,0,0,2,2,0,0,7,0,0,0,3,8,0,0,2,3,3,0,0,3,1
1,0,0,0,0,0,0,0,0,5,1,6,0,0,0,0,0,0,0,0,0,0,5,1,5,0,0,0,0,0,0,0,0,0,0,5,2,0,0,6,1
1,1,1,1,1,1,1,1,1,1,1,1,1,1,1,1,1,1,1,1,1,1,1,1,1,1,1,1,1,1,1,1,1,1,1,1,1,1,1,1,1